100
C--P------
---PBVB-B-
-PPP------
-H--B-B-H-
--------PP
PPPPV-PPP-
--DP--P---
---------B
-----BB---
--BBB-----